Isolated Chamber
An Interactive Fiction by Filip Conic
Release 1 / Serial number 240411 / Inform 7 build 6M62 (I6/v6.34 lib 6/12N) SD

Chamber
You jolt up at the sound thunder. You find yourself on a bare raggedy mattress that looks about 100 years old. The mattress is sitting on a metal bed frame. The room around you isn't any nicer than the bed. Plain grey concrete everywhere you look, except for the tiny spotlight in the middle of the ceiling allowing in the scarce bit of light provided by the rainy and overcast day. On the other side of the room you see another plain metal table. Woohoo, how exciting!

You can see a metal bed frame (on which is a raggedy old mattress) and a metal table (on which is an old wooden dreidel) here.

>spin bed
That doesn't seem to spin very well.

>spin dreidel
You need to take the dreidel first.

>x dreidel
An intricately carved dreidel, with gold color inscriptions that seem to shimmer a rainbow in the little bit of light provided by the room light. You can't tell what the inscriptions mean but they're definitely not anything you've seen before. 

Seems like the only redeeming quality of this depressing ass room.

>drop dreidel
Dropped.

>spin dreidel
You need to take the dreidel first.

* * *

>spin dreidel
Well you can't do that by looking at it.

>take dreidel
Taken.

>drop dreidel
Dropped.

* * *

>spin the dreidel
Well you can't do that by looking at it.

"SpinCount" = number: 0

>take dreidel
Taken.

"SpinCount" = number: 0

>spin dreidel
You spun the dreidel
"SpinCount" = number: 1

>spin dreidel
The dreidel spins gracefully on the metal table's surface. You watch it for a while but it doesn't seem to be slowing down.

"SpinCount" = number: 2

>x dreidel
An intricately carved dreidel, with gold color inscriptions that seem to shimmer a rainbow in the little bit of light provided by the room light. The inscriptions are beautiful but they're definitely not anything you've seen before. 

Seems like the only redeeming quality of this depressing ass room.

"SpinCount" = number: 2

>look at table
Ahh another beautiful piece of contemporary furniture. The mostly rusted plain metal table.

"SpinCount" = number: 2

>x table
Ahh another beautiful piece of contemporary furniture. The mostly rusted plain metal table.

"SpinCount" = number: 2

>x dreidel
An intricately carved dreidel, with gold color inscriptions that seem to shimmer a rainbow in the little bit of light provided by the room light. The inscriptions are beautiful but they're definitely not anything you've seen before. 

Seems like the only redeeming quality of this depressing ass room.

"SpinCount" = number: 2

>x dreidel
An intricately carved dreidel, with gold color inscriptions that seem to shimmer a rainbow in the little bit of light provided by the room light. The inscriptions are beautiful but they're definitely not anything you've seen before. 

Seems like the only redeeming quality of this depressing ass room.

"SpinCount" = number: 2

>spin dreidel
The dreidel spins gracefully on the metal table's surface. You watch it for a while but it doesn't seem to be slowing down.

"SpinCount" = number: 3

* * *

>spin the dreidel
Well you can't do that by looking at it.

"SpinCount" = number: 0

>take the dreidel
Taken.

"SpinCount" = number: 0

>spin the dreidel
You spun the dreidel
"SpinCount" = number: 1

>spin the dreidel
It still hasn't stopped. This can't be real... None of this can be real. What is happening? Where am I? Is there a message to any of this? I don't care, I NEED TO WAKE UP
"SpinCount" = number: 2

* * *

>spin the dreidel
Well you can't do that by looking at it.

"SpinCount" = number: 0

>x bed
An old metal bed frame half rusted away. Seems like it's bolted to the floor and hasn't moved in decades.

On the metal bed frame is a raggedy old mattress.

"rotating of the old wooden dreidel" = truth state: false

>x mattress
This mattress has seen better days. It's thin, torn, and the stuffing's is coming out... wait are those brown spots moving?

"rotating of the old wooden dreidel" = truth state: false

>x table
Ahh another beautiful piece of contemporary furniture. The mostly rusted plain metal table.

On the metal table is an old wooden dreidel.

"rotating of the old wooden dreidel" = truth state: false

>x dreidel
An intricately carved dreidel, with gold color inscriptions that seem to shimmer a rainbow in the little bit of light provided by the room light. The inscriptions are beautiful but they're definitely not anything you've seen before. 

Seems like the only redeeming quality of this depressing ass room.

"rotating of the old wooden dreidel" = truth state: false

>i
You are carrying nothing.

"rotating of the old wooden dreidel" = truth state: false

>take dreidel
Taken.

"rotating of the old wooden dreidel" = truth state: false

>spin the dreidel
The dreidel spins gracefully on the metal table's surface. You watch it for a while but it doesn't seem to be slowing down.

"rotating of the old wooden dreidel" = truth state: true

>x dreidel
An intricately carved dreidel, with gold color inscriptions that seem to shimmer a rainbow in the little bit of light provided by the room light. The inscriptions are beautiful but they're definitely not anything you've seen before. 

Seems like the only redeeming quality of this depressing ass room.

"rotating of the old wooden dreidel" = truth state: true

>spin dreidel
The dreidel spins gracefully on the metal table's surface. You watch it for a while but it doesn't seem to be slowing down.

"rotating of the old wooden dreidel" = truth state: true

* * *

>sping
That's not a verb I recognise.

>spin
What do you want to spin?

>dreidel
You need to take the dreidel first.

>x room
You can't see any such thing.

>x chamber
You can't see any such thing.

>you are here
That's not a verb I recognise.

>x dreidel
An intricately carved dreidel, with gold color inscriptions that shimmer in the light. It feels oddly out of place here.

The inscriptions catch your eye. They're symbols from a language lost to time, yet they seem to spark a deep memory within you. You can't help but spin the dreidel.

>i
You are carrying:
  an old wooden dreidel

>spin dreidel
The dreidel spins gracefully on the surface, eventually coming to a stop. Watching it spin, you feel a momentary sense of peace in this bleak chamber.

The dreidel spins gracefully on the steel table's surface, eventually coming to a stop. Watching it spin, you feel a momentary sense of peace in this bleak chamber.

>spin bed
That doesn't seem to spin very well.

>pull bed
It is fixed in place.

>move bed
It is fixed in place.

>test
>--> The following tests are available:
'test me'

>tes me
That's not a verb I recognise.

>test me
(Testing.)

>[1] look
Chamber
You find yourself in a stark, dimly lit chamber. There's no door or window, and the walls are cold and unyielding.

You can see a steel bed frame (on which is a raggedy old mattress) and a steel table here.

>[2] examine bed frame
A solid steel bed frame, bolted to the floor. It looks like it hasn't moved in decades.

On the steel bed frame is a raggedy old mattress.

>[3] examine mattress
This mattress has seen better days. It's thin, torn, and the stuffing is coming out, making it anything but comfortable.

>[4] examine table
A heavy steel table, secured to the ground. It's cold to the touch, with nothing on it.

>[5] examine dreidel
An intricately carved dreidel, with gold color inscriptions that shimmer in the light. It feels oddly out of place here.

The inscriptions catch your eye. They're symbols from a language lost to time, yet they seem to spark a deep memory within you. You can't help but spin the dreidel.

>[6] take dreidel
You already have that.

>[7] spin dreidel
The dreidel spins gracefully on the surface, eventually coming to a stop. Watching it spin, you feel a momentary sense of peace in this bleak chamber.

The dreidel spins gracefully on the steel table's surface, eventually coming to a stop. Watching it spin, you feel a momentary sense of peace in this bleak chamber.

>examine bed frame
A solid steel bed frame, bolted to the floor. It looks like it hasn't moved in decades.

On the steel bed frame is a raggedy old mattress.

>push table
It is fixed in place.

>spin the dreidel
The dreidel spins gracefully on the surface, eventually coming to a stop. Watching it spin, you feel a momentary sense of peace in this bleak chamber.

The dreidel spins gracefully on the steel table's surface, eventually coming to a stop. Watching it spin, you feel a momentary sense of peace in this bleak chamber.

>move bed
It is fixed in place.

* * *

>t dreidel
That's not a verb I recognise.

>take dreidel
Taken.

"SpinCount" = number: 0

* * *

>spin dreidel
You spun the dreidel
"SpinCount" = number: 1

>x dreidel
Damn that thing just keeps on going

"SpinCount" = number: 2

>x dreidel
This is getting a little freaky, it's just spinning, and spinning, and spinning...

"SpinCount" = number: 3

>look at dreidel
It almost looks like it's speeding up? What the hell is going on?

"SpinCount" = number: 4

>look at dreidel
It still hasn't stopped. This can't be real... None of this can be real. What is happening? Where am I? Is there a message to any of this? I don't care, I NEED TO WAKE UP!

"SpinCount" = number: 5

>look at dreidel
It still hasn't stopped. This can't be real... None of this can be real. What is happening? Where am I? Is there a message to any of this? I don't care, I NEED TO WAKE UP!

"SpinCount" = number: 6

>look at dreidel
It still hasn't stopped. This can't be real... None of this can be real. What is happening? Where am I? Is there a message to any of this? I don't care, I NEED TO WAKE UP!

"SpinCount" = number: 7

>look at dreidel
It still hasn't stopped. This can't be real... None of this can be real. What is happening? Where am I? Is there a message to any of this? I don't care, I NEED TO WAKE UP!

"SpinCount" = number: 8

* * *

>take dreidel
Taken.

"SpinCount" = number: 0

>spin
(the old wooden dreidel)
You spun the dreidel
"SpinCount" = number: 1

>x dreidel
An intricately carved dreidel, with gold color inscriptions that seem to shimmer a rainbow in the little bit of light provided by the room light. The inscriptions are beautiful but they're definitely not anything you've seen before. 

Damn that thing just keeps on going
"SpinCount" = number: 1

>spin
(the old wooden dreidel)
The dreidel spins gracefully on the metal table's surface. You watch it for a while but it doesn't seem to be slowing down.

"SpinCount" = number: 2

>x dreidel
An intricately carved dreidel, with gold color inscriptions that seem to shimmer a rainbow in the little bit of light provided by the room light. The inscriptions are beautiful but they're definitely not anything you've seen before. 

This is getting a little freaky, it's just spinning, and spinning, and spinning...

"SpinCount" = number: 2

>spin dreidel
The dreidel spins gracefully on the metal table's surface. You watch it for a while but it doesn't seem to be slowing down.

"SpinCount" = number: 3

* * *

>take dreidel
Taken.

"SpinCount" = number: 0

>spin dreidel
Damn that thing just keeps on going
"SpinCount" = number: 1

>look at dreidel
This is getting a little freaky, it's just spinning, and spinning, and spinning...

"SpinCount" = number: 3

>x dreidel
It still hasn't stopped. This can't be real... None of this can be real. What is happening? Where am I? Is there a message to any of this? I don't care, I NEED TO WAKE UP!

"SpinCount" = number: 4

* * *

>spin dreidel
Damn that thing just keeps on going
"SpinCount" = number: 1

>spin dreidel
This is getting a little freaky, it's just spinning, and spinning, and spinning...

"SpinCount" = number: 2

>spin dreidel
It almost looks like it's speeding up? What the hell is going on?

"SpinCount" = number: 3

>spin dreidel
It still hasn't stopped. This can't be real... None of this can be real. What is happening? Where am I? Is there a message to any of this? I don't care, I NEED TO WAKE UP!

"SpinCount" = number: 4

>spin dreidel
It still hasn't stopped. This can't be real... None of this can be real. What is happening? Where am I? Is there a message to any of this? I don't care, I NEED TO WAKE UP!

"SpinCount" = number: 5

>spin dreidel
It still hasn't stopped. This can't be real... None of this can be real. What is happening? Where am I? Is there a message to any of this? I don't care, I NEED TO WAKE UP!

"SpinCount" = number: 6

>spin dreidel
It still hasn't stopped. This can't be real... None of this can be real. What is happening? Where am I? Is there a message to any of this? I don't care, I NEED TO WAKE UP!

"SpinCount" = number: 7

>spin dreidel
It still hasn't stopped. This can't be real... None of this can be real. What is happening? Where am I? Is there a message to any of this? I don't care, I NEED TO WAKE UP!

"SpinCount" = number: 8

>spin dreidel
It still hasn't stopped. This can't be real... None of this can be real. What is happening? Where am I? Is there a message to any of this? I don't care, I NEED TO WAKE UP!

"SpinCount" = number: 9

>spin dreidel
It still hasn't stopped. This can't be real... None of this can be real. What is happening? Where am I? Is there a message to any of this? I don't care, I NEED TO WAKE UP!

"SpinCount" = number: 10

>spin dreidel
It still hasn't stopped. This can't be real... None of this can be real. What is happening? Where am I? Is there a message to any of this? I don't care, I NEED TO WAKE UP!

"SpinCount" = number: 11

>spin dreidel
It still hasn't stopped. This can't be real... None of this can be real. What is happening? Where am I? Is there a message to any of this? I don't care, I NEED TO WAKE UP!

"SpinCount" = number: 12

>spin dreidel
It still hasn't stopped. This can't be real... None of this can be real. What is happening? Where am I? Is there a message to any of this? I don't care, I NEED TO WAKE UP!

"SpinCount" = number: 13

>x dreidel
It still hasn't stopped. This can't be real... None of this can be real. What is happening? Where am I? Is there a message to any of this? I don't care, I NEED TO WAKE UP!

"SpinCount" = number: 13

>x dreidel
It still hasn't stopped. This can't be real... None of this can be real. What is happening? Where am I? Is there a message to any of this? I don't care, I NEED TO WAKE UP!

"SpinCount" = number: 13

* * *

>spin dreidel
Damn that thing just keeps on going
"SpinCount" = number: 1

>x dreidel
This is getting a little freaky, it's just spinning, and spinning, and spinning...

"SpinCount" = number: 3

* * *

>take dreidel
Taken.

"SpinCount" = number: 0

>spin the dreidel
You spun the dreidel
"SpinCount" = number: 1

>spin the dreidel
Damn that thing just keeps on going
"SpinCount" = number: 3

>x dreidel
An old dreidel

It almost looks like it's speeding up? What the hell is going on?

"SpinCount" = number: 4

* * *

>take dreidel
Taken.

"SpinCount" = number: 0

>x dreidel
An intricately carved dreidel, with gold color inscriptions that shimmer in the light. It feels oddly out of place here.

The inscriptions catch your eye. They're symbols from a language lost to time, yet they seem to spark a deep memory within you. You can't help but spin the dreidel.

* * *

>test
>--> The following tests are available:
'test me'

>xx
That's not a verb I recognise.

>x
What do you want to examine?

>x
What do you want to examine?

>x bed
An old metal bed frame half rusted away. Seems like it's bolted to the floor and hasn't moved in decades.

On the metal bed frame is a raggedy old mattress.

"rotating of the old wooden dreidel" = truth state: false
"SpinCount" = number: 0

* * *

>x bed
An old metal bed frame half rusted away. Seems like it's bolted to the floor and hasn't moved in decades.

On the metal bed frame is a raggedy old mattress.

"SpinCount" = number: 0

>take dreidel
Taken.

"rotating of the old wooden dreidel" = truth state: false

>spin dreidel
The dreidel spins gracefully on the metal table's surface. You watch it for a while but it doesn't seem to be slowing down.

"rotating of the old wooden dreidel" = truth state: true

* * *

>x bed
An old metal bed frame half rusted away. Seems like it's bolted to the floor and hasn't moved in decades.

On the metal bed frame is a raggedy old mattress.

"SpinCount" = number: 0

>x bed
An old metal bed frame half rusted away. Seems like it's bolted to the floor and hasn't moved in decades.

On the metal bed frame is a raggedy old mattress.

"SpinCount" = number: 0

>x dreidel
Damn that thing just keeps on going

"SpinCount" = number: 2

* * *

>x dreidel
An intricately carved dreidel, with gold color inscriptions that seem to shimmer a rainbow in the little bit of light provided by the room light. The inscriptions are beautiful but they're definitely not anything you've seen before. 

Seems like the only redeeming quality of this depressing ass room.

"SpinCount" = number: 0

>i
You are carrying nothing.

"rotating of the old wooden dreidel" = truth state: false
"SpinCount" = number: 0

>take dreidel
Taken.

"rotating of the old wooden dreidel" = truth state: false
"SpinCount" = number: 0

>spin dreidel
The dreidel spins gracefully on the metal table's surface. You watch it for a while but it doesn't seem to be slowing down.

"rotating of the old wooden dreidel" = truth state: false
"SpinCount" = number: 1

* * *

>x dreidel
An intricately carved dreidel, with gold color inscriptions that seem to shimmer a rainbow in the little bit of light provided by the room light. The inscriptions are beautiful but they're definitely not anything you've seen before. 

Seems like the only redeeming quality of this depressing ass room.

"SpinCount" = number: 0

>look at dreidel
An intricately carved dreidel, with gold color inscriptions that seem to shimmer a rainbow in the little bit of light provided by the room light. The inscriptions are beautiful but they're definitely not anything you've seen before. 

Seems like the only redeeming quality of this depressing ass room.

"SpinCount" = number: 0

>take dreidel
Taken.

"SpinCount" = number: 0

* * *

>spin dreidel
You spun the dreidel
"SpinCount" = number: 1

>spin dreidel
Damn that thing just keeps on going
"SpinCount" = number: 2

>spin dreidel
This is getting a little freaky, it's just spinning, and spinning, and spinning...

"SpinCount" = number: 3

>x dreidel
It still hasn't stopped. This can't be real... None of this can be real. What is happening? Where am I? Is there a message to any of this? I don't care, I NEED TO WAKE UP!

"SpinCount" = number: 4

>x dreidel
It still hasn't stopped. This can't be real... None of this can be real. What is happening? Where am I? Is there a message to any of this? I don't care, I NEED TO WAKE UP!

"SpinCount" = number: 4

>spin dreidel
It still hasn't stopped. This can't be real... None of this can be real. What is happening? Where am I? Is there a message to any of this? I don't care, I NEED TO WAKE UP!

"SpinCount" = number: 4

>spin dreidel
It still hasn't stopped. This can't be real... None of this can be real. What is happening? Where am I? Is there a message to any of this? I don't care, I NEED TO WAKE UP!

"SpinCount" = number: 4

>x dreidel
It still hasn't stopped. This can't be real... None of this can be real. What is happening? Where am I? Is there a message to any of this? I don't care, I NEED TO WAKE UP!

"SpinCount" = number: 4

* * *

>x dreidel
An intricately carved dreidel, with gold color inscriptions that seem to shimmer a rainbow in the little bit of light provided by the room light. The inscriptions are beautiful but they're definitely not anything you've seen before. 

Seems like the only redeeming quality of this depressing ass room.

"SpinCount" = number: 0

>take dreidel
Taken.

"SpinCount" = number: 0

* * *

>spin dreidel
You spun the dreidel
"SpinCount" = number: 1

>x dreidel
You see nothing special about the nondescript old wooden dreidel.

Damn that thing just keeps on going
"SpinCount" = number: 3

* * *

>take dreidel
Taken.

"SpinCount" = number: 0

>x dreidel
 

An intricately carved dreidel, with gold color inscriptions that seem to shimmer a rainbow in the little bit of light provided by the room light. The inscriptions are beautiful but they're definitely not anything you've seen before. 

Seems like the only redeeming quality of this depressing ass room.

"SpinCount" = number: 0

* * *

>x dreidel
An intricately carved dreidel, with gold color inscriptions that seem to shimmer a rainbow in the little bit of light provided by the room light. The inscriptions are beautiful but they're definitely not anything you've seen before. 

Seems like the only redeeming quality of this depressing ass room.

"SpinCount" = number: 0

>x dreidel
An intricately carved dreidel, with gold color inscriptions that seem to shimmer a rainbow in the little bit of light provided by the room light. The inscriptions are beautiful but they're definitely not anything you've seen before. 

Seems like the only redeeming quality of this depressing ass room.

"SpinCount" = number: 0

>spin dreidel
Well you can't do that by looking at it.

"SpinCount" = number: 0

>take dreidel
Taken.

"SpinCount" = number: 0

* * *

>x dreidel
This is getting a little freaky, it's just spinning, and spinning, and spinning...

"SpinCount" = number: 3

>x dreidel
It almost looks like it's speeding up? What the hell is going on?

"SpinCount" = number: 3

>x dreidel
It almost looks like it's speeding up? What the hell is going on?

"SpinCount" = number: 3

* * *

>x dreidel
This is getting a little freaky, it's just spinning, and spinning, and spinning...

"SpinCount" = number: 3

>look at dreidel
It still hasn't stopped. This can't be real... None of this can be real. What is happening? Where am I? Is there a message to any of this? I don't care, I NEED TO WAKE UP

"SpinCount" = number: 8

>look dreidel
It still hasn't stopped. This can't be real... None of this can be real. What is happening? Where am I? Is there a message to any of this? I don't care, I NEED TO WAKE UP

"SpinCount" = number: 10

>watch dreidel
It still hasn't stopped. This can't be real... None of this can be real. What is happening? Where am I? Is there a message to any of this? I don't care, I NEED TO WAKE UP

"SpinCount" = number: 12

>x dreidel
It still hasn't stopped. This can't be real... None of this can be real. What is happening? Where am I? Is there a message to any of this? I don't care, I NEED TO WAKE UP

"SpinCount" = number: 14

* * *

>x dreidel
This is getting a little freaky, it's just spinning, and spinning, and spinning...

"SpinCount" = number: 3

>x dreidel
It almost looks like it's speeding up? What the hell is going on?

"SpinCount" = number: 4

>x dreidel
It still hasn't stopped. This can't be real... None of this can be real. What is happening? Where am I? Is there a message to any of this? I don't care, I NEED TO WAKE UP!

"SpinCount" = number: 5

>x dreidel
It still hasn't stopped. This can't be real... None of this can be real. What is happening? Where am I? Is there a message to any of this? I don't care, I NEED TO WAKE UP!

"SpinCount" = number: 6

>spin dreidel
It still hasn't stopped. This can't be real... None of this can be real. What is happening? Where am I? Is there a message to any of this? I don't care, I NEED TO WAKE UP!

"SpinCount" = number: 7

* * *

>x dreidel
An intricately carved dreidel, with gold color inscriptions that seem to shimmer a rainbow in the little bit of light provided by the room light. The inscriptions are beautiful but they're definitely not anything you've seen before. 

Seems like the only redeeming quality of this depressing ass room.

"SpinCount" = number: 0

>x bed
An old metal bed frame half rusted away. Seems like it's bolted to the floor and hasn't moved in decades.

On the metal bed frame is a raggedy old mattress.

"SpinCount" = number: 0

* * *

>x room
You can't see any such thing.

* * *

>x chamber
You can't see any such thing.

>x self
As good-looking as ever.

>x dreidel
An intricately carved dreidel, with gold color inscriptions that shimmer in the light. It feels oddly out of place here.

The inscriptions catch your eye. They're symbols from a language lost to time, yet they seem to spark a deep memory within you. You can't help but spin the dreidel.

>take dreidel
You already have that.

>x dreidel
An intricately carved dreidel, with gold color inscriptions that shimmer in the light. It feels oddly out of place here.

The inscriptions catch your eye. They're symbols from a language lost to time, yet they seem to spark a deep memory within you. You can't help but spin the dreidel.

>x bed
A solid steel bed frame, bolted to the floor. It looks like it hasn't moved in decades.

On the steel bed frame is a raggedy old mattress.

* * *

>x self
As good-looking as ever.

>go north
You can't go that way.